13
17
#################
E               #
############### #
#             # #
#             # #
#             # #
############### #
#               #
##### ###########
#   # #	        #
##### ###########
#               #
##########S######